be was, were been : быть
beat beat beaten : бить
become became become : становиться
begin began begun : начинать
bend bent bent : гнуть
bet bet bet : держать пари
bite bit bitten : кусать
blow blew blown : дуть
break broke broken : ломать
bring brought brought : приносить
build built built : строить
buy bought bought : покупать
catch caught caught : ловить
choose chose chosen : выбирать
come came come : приходить
cost cost cost : стоить
cut cut cut : резать
deal dealt dealt : иметь дело
dig dug dug : копать
do did done : делать
draw drew drawn : рисовать
drink drank drunk : пить
drive drove driven : ездить
eat ate eaten : есть
fall fell fallen : падать
feed fed fed : кормить
feel felt felt : чувствовать
fight fought fought : драться
find found found : находить
fly flew flown : летать
forget forgot forgotten : забывать о (чём-либо)
forgive forgave forgiven : прощать
freeze froze frozen : замерзать
get got got : получать
give gave given : дать
go went gone : идти
grow grew grown : расти
hang hung hung : вешать
have had had : иметь
hear heard heard : слышать
hide hid hidden : прятать
hit hit hit : ударять
hold held held : держать
hurt hurt hurt : ранить
keep kept kept : хранить
know knew known : знать
lay laid laid : класть
lead led led : вести за собой
leave left left : покидать
lend lent lent : одалживать
let let let : позволять
lie lay lain : лежать
light lit lit : зажигать
lose lost lost : терять
make made made : делать
mean meant meant : значить
meet met met : встречать
pay paid paid : платить
put put put : ставить
read read read : читать
ride rode ridden : ехать верхом
ring rang rung : звенеть
rise rose risen : восходить
run ran run : бежать
say said said : говорить
see saw seen : видеть
seek sought sought : искать
sell sold sold : продавать
send sent sent : посылать
set set set : устанавливать
shake shook shaken : трясти
shine shone shone : светить
shoot shot shot : стрелять
show showed shown : показать
shut shut shut : закрывать
sing sang sung : петь
sink sank sunk : тонуть
sit sat sat : сидеть
sleep slept slept : спать
speak spoke spoken : говорить
spend spent spent : тратить
stand stood stood : стоять
steal stole stolen : воровать
stick stuck stuck : втыкать
strike struck struck : ударять
swear swore sworn : клясться
sweep swept swept : мести
swim swam swum : плавать
swing swung swung : качаться
take took taken : брать
teach taught taught : учить
tear tore torn : рвать
tell told told : рассказывать
think thought thought : думать
throw threw thrown : бросать
understand understood understood : понимать
wake woke woken : просыпаться
wear wore worn : носить (одежду)
win won won : победить
write wrote written : писать
